day
1325394000
1325480400
1325566800
1325653200
1325739600
1325826000
1325912400
1325998800
1326085200
1326171600
1326258000
1326344400
1326430800
1326517200
1326603600
1326690000
1326776400
1326862800
1326949200
1327035600
1327122000
1327208400
1327294800
1327381200
1327467600
1327554000
1327640400
1327726800
1327813200
1327899600
1327986000
1328072400
1328158800
1328245200
1328331600
1328418000
1328504400
1328590800
1328677200
1328763600
1328850000
1328936400
1329022800
1329109200
1329195600
1329282000
1329368400
1329454800
1329541200
1329627600
1329714000
1329800400
1329886800
1329973200
1330059600
1330146000
1330232400
1330318800
1330405200
1330491600
1330578000
1330664400
1330750800
1330837200
1330923600
1331010000
1331096400
1331182800
1331269200
1331355600
1331442000
1331524800
1331611200
1331697600
1331784000
1331870400
1331956800
1332043200
1332129600
1332216000
1332302400
1332388800
1332475200
1332561600
1332648000
1332734400
1332820800
1332907200
1332993600
1333080000
1333166400
1333252800
1333339200
1333425600
1333512000
1333598400
1333684800
1333771200
1333857600
1333944000
1334030400
1334116800
1334203200
1334289600
1334376000
1334462400
1334548800
1334635200
1334721600
1334808000
1334894400
1334980800
1335067200
1335153600
1335240000
1335326400
1335412800
1335499200
1335585600
1335672000
1335758400
1335844800
1335931200
1336017600
1336104000
1336190400
1336276800
1336363200
1336449600
1336536000
1336622400
1336708800
1336795200
1336881600
1336968000
1337054400
1337140800
1337227200
1337313600
1337400000
1337486400
1337572800
1337659200
1337745600
1337832000
1337918400
1338004800
1338091200
1338177600
1338264000
1338350400
1338436800
1338523200
1338609600
1338696000
1338782400
1338868800
1338955200
1339041600
1339128000
1339214400
1339300800
1339387200
1339473600
1339560000
1339646400
1339732800
1339819200
1339905600
1339992000
1340078400
1340164800
1340251200
1340337600
1340424000
1340510400
1340596800
1340683200
1340769600
1340856000
1340942400
1341028800
1341115200
1341201600
1341288000
1341374400
1341460800
1341547200
1341633600
1341720000
1341806400
1341892800
1341979200
1342065600
1342152000
1342238400
1342324800
1342411200
1342497600
1342584000
1342670400
1342756800
1342843200
1342929600
1343016000
1343102400
1343188800
1343275200
1343361600
1343448000
1343534400
1343620800
1343707200
1343793600
1343880000
1343966400
1344052800
1344139200
1344225600
1344312000
1344398400
1344484800
1344571200
1344657600
1344744000
1344830400
1344916800
1345003200
1345089600
1345176000
1345262400
1345348800
1345435200
1345521600
1345608000
1345694400
1345780800
1345867200
1345953600
1346040000
1346126400
1346212800
1346299200
1346385600
1346472000
